{
  "entities": [
    {
      "type": "Player",
      "settings": {
        "name": "player",
        "layerName": "entity0",
        "pos": {
          "x": 230,
          "y": 270
        }
      }
    },
    {
      "type": "Flag",
      "settings": {
        "name": "flag",
        "layerName": "entity0",
        "pos": {
          "x": 1152,
          "y": 384
        }
      }
    }
  ],
  "layers": [
    {
      "type": "TileLayer",
      "settings": {
        "layerSettings": {
          "name": "world",
          "tileset": [
            {
              "type": "Tile",
              "image": "brick.png",
              "settings": {}
            },
            {
              "type": "Tile",
              "image": "grassbrick.png",
              "settings": {}
            },
            {
              "type": "Tile",
              "image": "bamboo.png",
              "settings": {}
            }
          ]
        },
        "gridType": "StaticGrid",
        "gridSettings": {
          "cellsize": {
            "x": 64,
            "y": 64
          },
          "data": [
            [2, 1, 1, 1, 1, 1, 1, 1, 1, 1, 1, 1, 1, 1, 1],
            [2, 0, 0, 0, 3, 3, 0, 0, 0, 2, 0, 0, 0, 0, 2],
            [2, 0, 2, 0, 3, 3, 0, 2, 0, 2, 0, 3, 2, 0, 2],
            [2, 0, 2, 0, 0, 0, 0, 2, 0, 0, 0, 3, 2, 0, 3],
            [2, 0, 2, 1, 1, 1, 1, 1, 3, 3, 3, 3, 2, 0, 2],
            [2, 0, 2, 1, 3, 3, 3, 3, 3, 3, 3, 3, 3, 0, 2],
            [2, 0, 3, 1, 3, 0, 0, 0, 0, 0, 0, 0, 3, 0, 2],
            [2, 0, 3, 1, 3, 0, 2, 1, 1, 1, 1, 0, 3, 0, 2],
            [2, 0, 0, 3, 3, 0, 2, 0, 0, 0, 2, 0, 3, 0, 2],
            [3, 0, 0, 2, 3, 0, 2, 0, 3, 0, 2, 0, 3, 0, 2],
            [2, 0, 0, 2, 3, 0, 2, 0, 3, 0, 2, 0, 3, 0, 2],
            [2, 0, 0, 3, 3, 0, 2, 0, 3, 0, 2, 0, 3, 0, 2],
            [2, 0, 0, 3, 3, 0, 2, 0, 3, 0, 2, 0, 3, 0, 2],
            [2, 0, 3, 3, 3, 0, 2, 0, 3, 0, 2, 0, 3, 0, 2],
            [2, 0, 0, 3, 3, 0, 0, 0, 3, 0, 2, 0, 3, 0, 2],
            [2, 1, 0, 3, 3, 3, 3, 3, 3, 0, 2, 0, 3, 0, 2],
            [2, 1, 0, 3, 2, 1, 1, 1, 3, 0, 2, 0, 0, 0, 2],
            [2, 0, 0, 3, 2, 0, 0, 2, 3, 0, 2, 1, 1, 1, 1],
            [2, 0, 3, 3, 2, 0, 0, 2, 0, 0, 0, 0, 0, 0, 2],
            [2, 0, 2, 1, 1, 0, 0, 2, 0, 3, 3, 3, 3, 0, 2],
            [2, 0, 2, 1, 1, 0, 0, 2, 0, 3, 0, 0, 0, 0, 2],
            [2, 0, 3, 3, 3, 3, 0, 2, 0, 3, 0, 2, 1, 1, 1],
            [2, 0, 0, 0, 0, 3, 0, 2, 0, 3, 0, 0, 0, 0, 2],
            [2, 1, 1, 1, 0, 3, 0, 2, 0, 3, 3, 3, 3, 0, 2],
            [2, 0, 0, 0, 0, 3, 0, 0, 0, 0, 0, 0, 0, 0, 2],
            [2, 0, 3, 3, 3, 3, 3, 3, 2, 1, 1, 3, 3, 0, 2],
            [2, 0, 0, 0, 0, 0, 0, 3, 2, 1, 1, 3, 3, 0, 2],
            [2, 0, 0, 0, 0, 0, 0, 3, 2, 1, 1, 3, 0, 0, 2],
            [2, 0, 0, 2, 1, 0, 0, 3, 2, 1, 1, 3, 0, 2, 1],
            [2, 0, 0, 2, 1, 0, 0, 3, 2, 1, 1, 3, 0, 0, 2],
            [2, 0, 0, 0, 0, 0, 0, 0, 0, 0, 0, 3, 3, 0, 2],
            [2, 0, 0, 0, 0, 0, 0, 0, 0, 0, 0, 0, 0, 0, 2],
            [2, 1, 3, 3, 3, 3, 2, 1, 1, 3, 2, 1, 1, 1, 1],
            [2, 1, 1, 1, 1, 1, 1, 1, 1, 1, 1, 1, 1, 1, 1]
          ]
        }
      }
    },
    {
      "type": "Layer",
      "settings": {
        "name": "entity0",
        "depth": 1
      }
    }
  ]
}